{
  "id": 1,
  "level_id": "level_001",
  "tilemap": [
    ".......................................................",
    ".......................................................",
    ".......................................................",
    "...........S...........................................",
    ".......................................................",
    "...................................................X...",
    "..........................................B.....#######",
    "..........................................B.....#######",
    "..........................S...............B.....R######",
    "..........................................BBBBB.R######",
    "................................................R######",
    "...........................A....................R######",
    "..................####...###...............A....R######",
    ".........................................#####..R######",
    "................................................R######",
    "..........................................S.....B######",
    ".............###................................B######",
    "................................................B######",
    "...1....##......................T...............B######",
    "#################################EEEEEEEEEEEEEE########"
  ],
  "metadata": [
    { "key": "theme", "value": "cave" },
    { "key": "bgm", "value": "silence" },
    { "key": "author", "value": "adonis" }
  ],
  "objects": [
    {
      "id": "wh01",
      "type": "wormhole",
      "position": { "x": 20, "y": 11 },
      "range": {
        "shape": "box",
        "width": 10,
        "height": 1,
        "direction": "horizontal"
      },
      "targetTiles": ["p"],
      "cycle": ["Blocker", "Spines", "Variant"],
      "interval": 6,
      "stageDurations": {
        "push": 1.5,
        "restA": 0.75,
        "pull": 1.5,
        "restB": 0.75
      },
      "affects": ["Soul", "platforms"]
    }
  ]
}